#########################################
#   ###################   # #############
# ####                # # # #############
# ################### # # # #############
#                     # # # #############
##################### # # # #############
#   ##                # # # #############
# # ## ### ## ######### # # #############
# #    #   ##B#         # # #############
# # ## ################ # # #############
### ##             #### # # #############
### ############## ## # # # #############
###             ##    # # # #############
###### ######## ####### # # #############
###### ####               ###############
###### ###### ######## ##################
#######  ####   ########  ###############
########  ###  ######## #################
######### ###             ###############
######### #####  ## # ###################
######### ##### ### #####################
########   ### #### #####################
##########     # #  #####################
########## ###### #  ####################
########## #####    #  ##################
##########  #### ##### # ################
###########      ##### # ################
########### ############ ################
########### ####### #### ################
## A                #####################