####################################################################################################
#  # ##      #      #   ##  #     # #      ## # #       # ##    ##   #     # #   #                 #
# ##  # # ## # #### # # #  ## ###     ### ##    #######   #  ##  # # # ###     # ######## ######## #
#  ##   #  # #    #   #   ##   ##### ##    # ##    ##   # # #### ### # # ## ## #  #   ##  ##     # #
# ##  # ## # #### ## ######  ###   #  ####   #####  # # #   # ##  ## # #  #  ####   #  # ##  ### # #
#  #### ## #   ##  #  #   # ##   # ##  # ##### # ## # #######  ##  #   # ###    ######   ## ## # ###
##   #   # # #  ## #### #      ####### #  ##   #    #  #   ### ### ## ##   ## ###   ######     #   #
#### # # # ####  #      #########      ##    # # ##### # #   #  ## #  #  #  #  ## #  #     ### # # #
#  # #####   ### ## ##### ##   #  ############ #     #   ### ## #  # ### ## ##  # ## # ##### ##### #
# ##    ### ##   #   #    #  #   ##  ##   ##   ##### # # #   ## # ##   ###  ### #  #   ## #  #     #
#  #### #   #  # # #   #### ########  # #  # #   ##  ##### ###  #  ###   ## #   ## #####    ## ### #
# ###   # # # ## #####  #   ##     ##   ## # ### #  ##     #   ###   # #    # # #  #   # ##  # #   #
#     ##### # ####   #### ###  ######## #  #   ### #### #### #   ### ##### ## # # ## # #  ## # # ###
# #####     #  ##  #  #   #   ###   ##  # #### #   #    # #  ###   #   #    # ### #  #   ##### #  ##
#  # #  ## ###    ### # ### ####  #    ##      # ###### #   ## ### ### ## ### #     ## ###   # ##  #
## #   ##   ####### # # ##    #  ### # ####### #      # ###      # # #  #   #   ########   # # #####
## ### #  ###   #     # #  # ## ## # ###   ##  ###### #   ## # ###   ## # #####    ##    ### #     #
#    ### ## # # # ##### ## #  # #  #  ## # #  ## #    # # ## ###   ###  # #   ####  # #### # ### # #
####  ##  #   ### # # #  # ##   # ### #  # ##    # #### #  ###   ####  ## # # ## # ## #    #   # # #
## ##  ## # #   #     ## #### ### ##    ##  ###### #    ## ##  #  #   ##  # #  #    # # ## # # ### #
#   ##  # # ## ###### #   #    ##  ########      # ## # #  #  ##### ####### ## ## # # #  # ### #   #
# #####   ###   #   # ### ## #  ##        ##### ##  ##### ## ## #   #     # #   ### # ## #  #  ## ##
#  ## ######  # ### #  #   #### ###### ##     #  ##       #   # # #### ##   ###   # #  # ## # ##   #
##    #      ##   # ## ###    #     #  ### # ### ########## #   #   ##  ##### ### # ## ###  # #  # #
#### ## ## ######   ##  #  ## #####   ##   ###   #   # #    ### ###  ##  # #    # # ##  #  ## # ## #
#    ## ## #    ###  ## ####  #  ######## ###  # # #     # ## #   ## ### #   #### #  ## # ##  # ## #
### ##   #   ##   ##  #    # ###       #   #  #### #########  ## ##  #   # #  ##  ## ## # ## ## #  #
##  #  ##########  ####### # # ### ### # ### ## #  #      #  ##   # ## ### ##  # #####  # #  ## # ##
#  ## ##     #  ## #     #   #  #  # #   # #  # # #######   #####   #  ##   ##   ##    ## # ##  #  #
# ### ## # #   ##    # # ######   ## ##### # ##   ##    # ### # ###### #  #  #####  ####     ##### #
#     #  #### ##########  #   # ###  # ##  #    ###  ## #  #         # #### ##     ##    # #    #  #
# ##### ##     ##   #    ## # # # ##      ####### # ###   ## ## #### #    #  ## ###### ######## ## #
#   ##  #  # ###  #   # ##  # #    ## ## ##     #     # ###   # #  # # ## ## ##  #   ####   ##   # #
## ##  ## ## #   ### ####  ## ####  ###  ## # ### ### ###   ### ##   #### #   ## # #    # #  # #   #
#   ####   ### ####   #   ###   ###  ###  # ###     #  #  ###   #  #  ##  ### #  # #### # ## ##### #
###   ### ###  ##   ### ### ###   ##  ###    #  ## ## ## ## # ### ###  # ## # ##      # #  #  ##   #
# ###  ## #   ##  ####  ##    ###  ##  #####   ###  #    ## #  ####### # ## #  ######## ## ##  ### #
#   ##    # ###  ###   ##  ##   ## #  ##   ##### ## ######  ##     # # #  # ##  ##    #     ##   # #
# # ### ### #   ##   #### #####  #   ##  #    ##           ####### # # ## #  ##  # ## # # # #### ###
# #  ## #   ### #### # #  #   ## ## ##  #####  #############   #   # #  # # ####   #  #####    #   #
# ####  # ####   ##  #   ## # #   ##### # # ##   ##       ## # ## ## ## # #  # ######   ##  # #### #
#    # ## ##   #  # ## # #  # # #  ####   # #### #  ##### #  #    #       ##      # ## ##  ####    #
# ## #  #  ###### #  # #### # # ##  ##  # #    # # ##  #  # ### # # ######## # ##    #  ####    ## #
# #  ## ##    #   ## #  #   # #  ## #  ## ## ### # ###   ## # #######    ##  #  # ## ##    # ##### #
### ###  #### # # ## ##   # # ## ## # ##   # #   #  ## ###  #      ### #  ## ## #  #######   #   # #
#     ##  # # #####  #  #######  #  #  ### #   #### #  #   ## ####  #  ##  # #  ####     ###### ## #
B ###  ##   #   #   ### #    ## ## ###   # ## ###   # ## # ## #  ##   #### ### ##    ### ##  #  ## #
#   ##  # #### ## ###   # ## #  #  #   ### #  ##  ### #  ###    #######  #   # #  #### #  ##   ##  #
## ######  # #    # # ### ##   ##### ###   # ##  ##     ##   ##  ##   ##   # #   ##    ##    # #  ##
#   #   ## # ###### # # #  #######     # ### #  #######  ## ### ##  #  ## ## # ##### #########   ###
# # # #    #     #  #   ##    # #  #####  ## # ##     ## #    ###  ### #   # # # #          ###### #
###   ###### ### # ####  ####     ##   ## #    #### #  ### ####   ## # ### # #   ## # # #####    # #
##  ### # #  #   #  # ## #  #######  # #  # ##  ##  ##   #   ## ###  #  ## # ###  #####    #  ##   #
#  ##   #   ## ####    #   ###  #   ##   ## #####  ### #   ###  #   ###  ###  ###  ###  ##   #### ##
# ##  # ## ### #  ## #####   ## # ###########     ## #######   ### ## ##  ### # ##  #  ####### ##  #
#    ## #  #   ##        ### ## #    ##       #####   #      ####   # ###  ## #  ## # ##       #  ##
#######   ## ###### # # ###   # ## ###  # ###### #### # #######   # # # ##  # ## #  #  # #### ## ###
#     #####       ### #   ### #  # ##  ####      #    #  ##   ## ##   #  ## # #    ### # #    ## # #
# # #  # ########  ## # #       ##  # ####  ## #   ## ## #  #    ####   ###   # #### # ### ##  #   #
# ####    # ##  ##  ###########  ## #   #  ##  #####   # # ### # #  ###   #####  #     #    ## ### #
#  # ####    ##  ## #   #     ## #  ### ## ## ## # # ### #  ####### # # #     ## # ###### ###   #  #
## #   #####  ##  # # # ## ## #  # ##   #   #  #     #   ## #     #     ######## # ##     #   ### ##
## # ###   ##  ## #   #  # ## ## #  # ##### ## ## #### ###    ### ## ####     #  #  # # #######   ##
#  #  #  # ###  # ######   #   ####   #   # ##  #  # #  #######   #   #   ## ## ### # #  ##   # #  #
# ###   ##   ## #     ########  # # #####    ## ## # ##   ##    # # ### #### #  ##    #A #  # # ####
# # # ###### ## # ## ##   # ### #       # ## ## #  #  ###  # ## #####   #  # # ##  ####### ## #    #
# #    #   ###  #  #    # #   # ##### # #### #  # ### # ## #  ####    ### ##   #  ###   #  #  # ## #
# # ##   #  ## ### ## ##### # #    ####  ##  # ##     # #  ##  #   ####    ########   #   ## ## #  #
# ###### ##  #  #   #   ##  # ####    ##  #### ## # #   # ##  ## #### ####   ##   ## ######  #### ##
#      #  ## ##   #####  # ##    #### ### #    #  ### ###  ##  # ##     ## #    #    #  # # ##     #
###### ##  # ######   ##    #### #    #   ## # #####   ### #  ## #  ###    ########### ##    ### # #
#   ## ### #    # ## ########  # # #### #  # ###   #####   ## #  # ## #######    #     ## ####   # #
# #  #  ## ## # #  #        ## # # # ## ##   #   #   ##  ####   ## #  # ##    ##   ## ##  #    ### #
# ## # ##  #  # ##   ######  # #   #     ##### ##### #  ##  ## ### ## #    ####  #  #  # ## ####   #
# #  #  ## # ## ### ##   ### # ######### #   # #   #   ##  ##  #   #  # ####  ####### ## #  #    # #
### ###  # # #    # #  #  #  #      ##   # #   # # #####  ### ### ### #  # ##  #    # #  # ####### #
##    ## ### #### # ##### # ## ### ##  ### ##### #  ##   ##       # # ## #  ## # ##   # ## ##   ## #
#  ## ##  ## #  # # ##    #  # #   #  ##   ##    ## #  #  #########   #  ##    # ### ## ##    # #  #
# ###  ## #  ##     #  # ### # # ### #### ##  ##### # ###  #   #    #   #### # # #    #  ###### # ##
#   ## #  # ###### ## ## #   # #      ##     ##     #   #### #   ########  # ### # #####  ##    #  #
# # #### ## #   ####   ### ### ######  ######### ###### ##   #####    # ##    #  ###   ##  # ##### #
# #    #  # # #    # #  ##   ####   # ##  ##     # # ##    # #  ## ##   ## # ## ###  #  ## #  # #  #
# ### ### #   # ## # ##  ###    # # #    ##  #####      ####### #  ####    #  # # # ### #  ## #   ##
# #     # ## ## #  #  ##   #### # # ### ### ## ##  #######  #   # ## ### ### ##   # # # # ##  # ####
# # ### #  ###  # ## #### ## #  # #   ###   #     ## #   ##   #   #    # #    ###   #   # ## ## ## #
# # #   ##  ## ## #   ##   # # ## ###     ### ######   #  ###### ## # ## ####   ##### # #  # ##  # #
# # ## ####  ###  # #  ###   #  #  ########   #    ## ### ##   #  ###  #   ## ### ##  #### #  ##   #
# # #   #### #   ##### # ### ## ##   #   ## #### #    # # #  # ##     #### #   #  #  ##    ##  ## ##
# # # #  # #   ### ##     ##  #  # # ###    # #  ## ### # # ##  ##### #    # #   ## ### ###### #   #
# # ####   #####    #### ##  ### # #  #####     #####   #   ###  ##   # ######## ##     #      ### #
# #  ##  #    ## ##  ##  #  ##   # ## #   ####### ##  # ##### ##  ## ## #   ##    ####### # # ##   #
# ##  # #######  ###  # ## ### ### ##   #   #   #    ##  #    ###  ####   #  #### #  #  # #####  ###
#  ## ####      ## ## # ## #   #    ##### # # #   # #### # # ## ##  ##  # ##   #  ##   ##     # ## #
##  #  # ## ## ##   #    #   ######  ## ### ##### # # ## # #     ##  # ##  ### # ### # #  ### #  # #
### ## #     ##### ############   ##    #   #   ### #  # # ## ##  ## #  ##  ## #   # #   ###  ## # #
# #  #   # #  ##    # #         #  ###### ### #     ##   # ## ### ## ##  ####  # # # #####   ### # #
# ## ########  ## # #   # ## #####     ## # # ### ###### #  #  ####   ####    #### ####    ### # # #
#  # #   ## ##    # #######  # # ### #    # #   ###    #### ##  ##  #  ##  #### #     # #### #     #
##     #     ## # #         ##       ## # #   #     ##       ##    ###    ##      # #   #      # # #
####################################################################################################
