####################################################################################################
# # # #    #    # #   #   #   #            #   # #    #      #   ## ##   ##    ##          #       #
# # #   ##   ##   # #   # ###   ####### ##   ###   ##   ## ### #  # #  #  # ##    ######## # #### ##
# #   # ####  ### # #####   ### ##    #  ###  ## ##### #####   ##     ## ##  ## ####    ## #    #  #
# #####    ##  ## # #  ####   ###  ## ##   ## #  ##  #  ##   #  ## ####   ##  #    # # ##  # # ### #
# #   # ## ###  #   ##    ###  #  ###  ###  ### ##  ## ##  # ##  #    ####### # ## # #    ## ###   #
#   # ###   ### ######## ## ##   ## ##  #  ###  #  ### #  ##  ##### #  #   #  ###  # ##########  # #
#####   # ### #   ##      #  #####   ##   ###  ## ## # # ### ##   #### # #   ##   ##   #      # ## #
# # ### # ##  ### #  ## # # ##     #  # #  #  ##     # #   ###  #  ### # #####  ###### # ####   #  #
#     # #  # ## # ####  #   #  # ####   ## # ##  # # #   #  #  ###  #  # #  #  ##    #   #  ##### ##
# ##### ##      # ##   ### ## ##    ######## ##### # ######## ## ## # ##   ## ###### ######   # #  #
#    ## ## #### # #  ### ###   #######    #  #     #   #   ## #   # #  ## ##  # ##     ##   #   ## #
# ##    #   ##  # # ##   #   ###     # ## # ## # #### ## #    # # # ##     # ## #  # ###  ######## #
# ####### #  ## # #    #   ###   ### #A## # #  # ##    # ###### # #  # # ### #    ##  #  ###    #  #
#  #   ## ##  ### # ######## # ### #    # # ####  #### # ##     # ## #####   ### ####   ##   ##   ##
## ## ##  #####   #  #   ##  #  #  ######     ### ##   #  ##### # #    #   ####  #    # #  #########
#  #   # ## #   #### # #  # ### ##      # ###     #  #### #   ###   ##   # #  # ### ### # ## ##    #
## ## ##    # ###      ##     # #  # #######  # # # ###   # #  ####  ########   #   ##  # #   # ####
#   #  ### ##  ##### #  ####### ## #  ##   # ###### ##  ### ##    ##  ##   #### #####  ## # # #    #
### # ###   ##     ######   #    #### #  # ####   ###  ##   #####  ####  #   ## #   ####  # #   ## #
##  #   ###  #####    #   #   ##  # # # ##      #  ## ##  ###  ###      ## #  # # #   ## ## ###### #
#  ## #  ## ##   #### # #########     #  #########  #    ## ##   ############ #   # #    #  #  #   #
# ##  ## #  #  # #  #   #     ####### ## # #    ### ####  # #  #   #   ## #   ## ##########   ## # #
# #  ##    ## ##   ###### ###  ##   ###  #   ## # #    ##   ## ## ## #      ###  # ##     ###### # #
# # ##  ####   ### #    # # ## #  #  ### ######   ####  # #  ###  #  ######## # ##  # ###      # # #
# #### ##  # #   # # ##   #  #   ### #      ##  #    ## ####  #  ## ##   # ##   ###   # ## ### # # #
#   #  ###   ### ### ####### ##### # ###### #  ### # ##    ##   ##     # #  # ### ### #  #  ##   # #
### # ##   ### # ##  #     # # ##  #    ##  # ## ###  #### #  # ###### # ## #  #    #   ###  ##### #
# # # #  # #   #  # ## ###      # #####    ##      ## #  # #### #    ###  # ##   ## ##### ##    ## #
#   # ####   # ## # #   #######    ## ############ #    ##    # # ##   ## #  ###### ##    ##### #  #
# ###    # # ###  # ###  #   ### #  # #    # #     # ######## ###  ## ##  # ##    #  # ##       # ##
# # #### ######  ##   #### #  #  ##   ####     #####   ##   #   ##  #    ##    ## ## #  ######### ##
# #        ##   #####  #   ## # #####  #   # # #   ###  # ##### ### ########## ## #  ##  ##   #    #
# #### # #  # # #   ##   #### #  # ###   ######### ##  ##     #  #  #  #     # #  # ####    # ######
#    ### ##   # # #  #####    ## #   ### #       # #  ##  ### ## ## ##   ###   # ##   ##### # #    #
####   ###### ### ## #     ####  # #  ## # ##### #   ##  ##   ##    #  #   ##########   ##  #   ## #
#  ###  # #    #  #    #####  # ## # ##  #  # ## ###### ### #  ###### ### ##    ## ####  ########  #
##   ##   ## ### ####### # ##   #  # #  ### #  #    #   # # #####   # ##  #  ##  #    ## #      # ##
#  ######  ###   #  ##     ### ## ##   ##   ## ####   #   #  ##   #    # ## #### # ##    ## ### #  #
##      ##  #  ### ##  ###     #   ####### ###   ###########    # # ## # ##   ## #  ######  #   ## #
#  # ######   ##    # ## # ## #### #   ##  #   #     #    ### #######  #  ###  # ##     #  ### ##  #
# ##      #####  ##   #  ###  #  # # ###  ########## # ##   ####    ## ##  ## ##  #####   ## #    ##
# ###### ###  # ####### ##   ## ## #  ## ## #      # #  ###    # ##  #  # ##   ##  #  #####  ####  #
#      #     ## #  ##    # ###  #  ## #  #    ####   ##   ## # #  ## ## # #  #  ##   ##   ##   ### #
# #### ## ##### ##  # ## #  ###   ##  # ### ###  ## #####  ### ##  #  ### # ####### ### # ## #     #
###  # ##   ##  ###    ####  #### #  ##     #   ##  #     ###   ## ##     #   ##    ##  #    #######
##  ##  ###    ## ## #    ##  ##    ########## ### ## ######  #  # ### ######  # ####  #######  ## #
#  #### # ######   ######  ##  ###### #          #  #  #   # ###   #   #    ## #  ##  ## #   ## #  #
# ###   #        # ##   # ####          # ## ## ## ### # #    #### # ### ## #  ##  # ##    ###    ##
#   ## ######### # #  #    # ##############   #      # # ######    ####   #   #### # #### ##   # ###
# #    #    #    #   #####       ##    # #  # ######## #  #   ## ####   #######    #    #    ###   #
# ####### #   ## ## ##   #########  ##   # ##  ##   #  # ## #  ####   ###   # ## # #### ## ### ### #
#    #  # # # #   ###  # ##   ##   ##### ###  ##  #   ## #  ##  ##  ### ###   #  # #  #  # #    ## #
#### ##   # #######   ## #  # #  ###   #  #####  ####### # #### #  ## # ##  # # ##   ### # ## ###  #
#  # ## ######      ###  # ##   ###  # ## # #   ##     # #    #   ##    #  ## # ######   #     #  ##
# ##  #    # # #######  ## ###### # ##  # #   ###  ###   #### ####### # # ##  #   ##   ### ##### ###
# ### ## # #       ##  ###   ##      ## # ## ## # ## #####  #    #    # # ### # #    ###   #       #
# # #  ### # #####  # ## ###  ########  #    #    #      # ##### # #### #   # ######## # ### ##### #
#   ##   # # #   # ##      ## ##    ### ###### ####### #   #  ## # ##   ### #  #   # #   #   #     #
# ###### #   # # #  ## ###  #    ##  ##   ##   #       ### # ##  #  ###     ##   #   ##### ### #####
#     #  # ### # # ##  # # #########  ###    ### ## ####     #  ###  #  ####### ####   ##  #      ##
## #### ####   # ###  ##   #       ##  #  ## # ###  ## ## #### ## ## # ##     ###  ###    #######  #
#  #     ##  ### ##  ### #### ######## ####     ### #  #  # #  #     ###  ###   ##   ###### #   ## #
## # #####  ##      ##   #  #        #    # # #     # ## ## # #### ####  ## ###  # #          ###  #
## # # #   ############ ## ## ###### #### ### ####### ## #  #   #  ##   ##    ## #### ###### ###  ##
#  # #   ### ##      #  #  ## #  #    # # ##   #    #      #### ## #  ###  #####  ##  ##     ##  ###
# ## ## ##    ### ## # ## ##    ## ##   #  ### # ## ### ######  ## # ## # ##   ##  ## #  # ###  ## #
#    #  #  ##  #   #   #  #  ##  #  ### ##  #  #  #   #   # #  ##  # #    ## #  ##  ### ####   ##  #
# ##### ######   ######## # #### ##  #  ### ##### ### ### #   ##  ## # ##    ##  ## ##    #  ##### #
#    ##     ### ## #    #   #  ##### ## #   ##    # #   ### ###  ##  #  # # ### ##   # #### ##  ## #
####  #####  #  #    ## ###   ##     #  # # #  #### ## ##   # # ##  ##########   ### #    #  ## #  #
#  ##    ### # #####  #   ## ### ######## # # ###    #    ###    ## #    #     # # # ### ###      ##
##  ####     # #   ## ### ####    #     # # # ##  ## ###### ## # #  ## # ### ###   #   #     # ## ##
#  ##  #######   #    # #      ## # ###   # #  #####     #     ### ### #  #  # ### ### #########   #
# ##  ## # # ########## ########  #  ### ## ##  #    ### # # ####  #   ##   ## ##    # ##    ##  # #
#    ##  #   #        #   #    # ###   ###   ## # #### # ### ##   ## #########  ### ##    ##  # ## #
# ######   #   #### # # # # ## # # ### ##  #  #   #    #  #     ###  #       ##      ######## #### #
#      ##########   # # #   #  #    ##  # ### ##### ## ## ## #####  ## ## # ##  ######    ###    ###
# # ##  #    #    ### # ###### ####  ## #  ####   # #   # #    #   #####  # #  ##  ##  ##  #  ##  ##
# #  ##   ## # #### #   #  # #  # # ##  ####    #   ### # ####   ###   # ## # ### ##  #### # ####  #
# ##  ## ### # # #  ##### ##   ##    # ###   ##### ##   #    #####   # #  ### #    # ##    # ## ## #
# ###  ###     #   ###       #  # #### ##  ####  #  ## #####  #    ### ## #     ## #  ## ###  #    #
#   ##   ######## ##   ######## # #  #  # ##    ### #  #   ##   ## ##  #  # ######## ##  # ## # ## #
# #  # #   #    # #  ###    ##### ## ## # ### ###   # ####  ########  ### #   #    #  # ##  ### ## #
# ## #### ## ## #   ##   ##  # #  #  #  # #     ## ##    ##      ##  ##   ### # ## ## #  ##   #  ###
#  ###    #   # # #### ##### #   ## ## ## #### ##  #### ##  # ####  #### ## # # ## #  ##  # # ##   #
##  #  # ## # # #    # #  ##   ###  ##  #  #   ## ## #  #  ##  #   ###      # # #    ####   #  ### #
## ## ####  ### ###### ##  ##### ##  ## ## # ###  ##   ## ### ## ### # # #### # ### ## #######   # #
#   #   #  ##   ##      ##    #  ### ##  # #  ## ##  #### ##  ## #   # #   ## #   ###  #     ###   #
### # ### #### ##  ######  ##   ##   #  ## ## #   ## #  # #  ##  # # # ###    ###   # ## ###   ### #
# # #  #  # #  #  ##      ##### #  # # ##   # # ###  ##   # ##  ## #   # ###### ### # #  # ###  #  #
# # ##   ## # ## ###### ####    # ####  ###   #  #  ### ###  ## #  #####  ##      # #   ## # ##   ##
#   ######  #    ## #   #  ## ###    ##   ### ## ## # ####  ##  # ##     ##  ## ### # ###    #######
# ### ##   #######    ### ##  # ####  ## ###  ## #  #      ##  ##  ### # #  #####   #   ## #    #  #
# #      #         #### #    ##  #   ##  ##  ##  ## ## ## ##  ####     #   ##   # ### #### #### # ##
# #### ##############   # ######   #  ## #  ### ##     #   # ######### #####  # # ##   ##  #    #  #
#   ## #      ##  # # ### ##     ####  #   ##   ############ # ##   ####     ## # #  ###  ## ##### #
B #    # ####  # ##    #   #### ## ## ####### ###   #   ##     #  #    # ###### # # ##   ##   #    #
# ## # #    ##      ##   #      #           #     #   #    # #   ### #   #        #    # #  #   ## #
####################################################################################################
