####################################################################################################
#     #   #      ##   #    ##                ### # # # # # ##       #     # ##    ##   #   #     # #
# ###   # # # # ##  # # # ##  ########### ##  #      #   #    ## ## # # #   #  ## #  #   #   ### # #
### ##### ### #    ##   #  ####    #   ##  ##   #### ###   ## #  #  # # ### ####    ### ######   # #
#   #   # ##  # ##########   ## ##   #  ##  ### #      ## ##  # ##### # # #    ######    #   ## ## #
# #   # #  # ## #    #  ####  #  ###### ###   ########  ###  ## # #   # # #### #    # ## # ###  #  #
# ##### ## #  ### ## ##    ## ##   ##   #   #    ##  ##   ## #  #   ### #    #   ## ###  #   # ## ##
# #     #  # ###   #  ### ##  #  #  # ### ######  # #####  # # ## ### # ## # ######  #  ### ## #   #
# ## #### ## # # ####  ##    ###### # # # ##   ## #     ## ###  # ##  # ## # ##   ## # ##   ## ## ##
#  #  ##  #       ####  ## ###   ## # #    # #  # #### ###   # ##  ## #  # # #  # ## # ## #  # ##  #
## ####  ## #####  ####  #     #  # # # ## # ## #  #     # #   ### ## ## # #   ####  #  # ## #  ## #
##      #####   ##  #### # ######   # ###  ###  ## # ######### # #    ## # ###  ##  ### # #  ##    #
#  ######  #  #  ##  # # # #   ######   # ###  ##  #      # #    ### ##  #   ## #  ##   # # ###### #
## ##   ##   ###  ## # # ### #     #### #   # ##  ### # ###   #####  #  ## #  ### #### ## #    #   #
#  #  # #  ### ## ##   # ##  ##### #  # ### # #  ###  #   # ### # ## # ### # ###     # #  # ## # ###
# ## ##   ## # ##  ### #  # ##   # ##   #     # ##   ## #     # #    #   ###     # #   # ##### #   #
#  ###  ###     ##  ## ##      ### #  ####### #  ###### #####   # ######   ###############   # ### #
## #   ##   ###  ## #   # #######  # ###    # ##      #     ## ## ##   ###     #   ##  ##  #     # #
## ## ### ### ##    # #####     # ## #   ## ######### #######  #  #  # # #### ## #  ##    ######## #
#  #   #  #    ######   ##  # #   #    #### #    ##   ##    #### ## ##     #  ## ## ## # ###    #  #
# ## # # ## ##    # # ###  ############## # # ##  # ###  ##   #  #   ## ## # ##   #  # #     ##   ##
# #### #  ##### ###    #  ## #   #  # # #   #  ##   #   #####   #### ##  # #    #### # #####  # ####
#    # ##  #    ##  ## # ##    #   ##   # ### #### ## ### # ######    ## # ######  # ###   ####    #
####   ### ## # #  ##### #  #### # ## # #   #    ###  #     ##   #### ## #   #    ## #   #   ##### #
#  ##### #  ### # ## #   ##   #  ###  # ### ## # #   ### # ##  # ##    # ### # ## ##   ##### #   # #
# ## # # ##  #  #  #   #### # ##  #  ## # # #  # # ###   #  # ##  #### #  #    #   # ### # #   # # #
#  #      ## # ### # ####   #  # ## ##  #   # ## #     ####   ###  #   ## ######## ###     ##### # #
## # ### ##  #  #  # # #  # ## ###   # ## ###  # #######  ##### ## ######    #   #  #  ###  ## # ###
##    #   # ###   ## #   #####  #  # # #  # ## # #    ###        #      #### ## ###   ## ##    #   #
#  #### ### # #####  ## ## ##  ## ####   ##    ### ##  #  ### #########  ##  #  # #####  #### ### ##
# ##    #   #     ## #     #  ###   ######### ##   ### # ## #   ##    ##  # ## ##    ###  #   # # ##
###  #### #### ##  # ##### # ## ### #   ## #  #  # # # # #  ###  # # #### # ##    ##   ##   ### #  #
##  ##    # #   ##   #     #    #   # #  #   ## #### # # # ## ##   #   ## #  ######## ### ###   ## #
#  ##  # ## # #  ###### ##### # # ######   ###  # #  # # #  #  ###### ##  ## #    ##  ##      #### #
# ### ####    ##  #   ###   ### #     #  #     ##   ##   ##   ##    #    ##  # ##  # ##  ## # ##   #
# #    ##  # #### # #     #  #  ##### #### # ##### ######### ##  ## ######## # ### #    #######  # #
#   ####  #####   # ## ##### # ##   #   ####  # #   # ## #   #  ##      ##   # #   ## ###       ## #
# ###  ## ##    ###  #   ##  # ## #####   ###   ###    #   #   ### ## #    ### ### #    # #######  #
#   ##     # ####   ####  # ##  #     ###   ###   ####   #######    ######  ## ##  # ## #  #    # ##
### #### # # ##   ###  ## # ### # # ### ###  #  #    ## ##   ##  # ##    ####  #  ## ##### ####    #
#      #####  ###     ##  # #   # #       ## # #####    #  #  # ####  ##  ##  ### #   ## #   ### # #
######     ##   ## # ##  ## # # # ### ### #  ###  ####### ###   #    ####    ##   # ###  # #   ### #
##  ###### ## #  # ###  ###   # #   #  #### ###  ##   #   ##  # # ############## ## ##  ## ###  ## #
#  ## #    #  ## ####  ## # ####### ##   #  # # ##  #   ###  ## #   # ##    # #  #     ##  # ##  # #
# ##  # ##### #  #    ### #  ##     ### ## ## #    #######  ### # #      ##   # ########  ## ### ###
# #  ##  ## ### ## ## #   ##  ## #### # #  #  # ####     #####  ####### ##  # # # #    ## ## # #  ##
#   ####  #     #  #### ###  ##  # #  #   ## ##  #   ###   # ##  #    ###  ## #   # # ##       ##  #
## ###### ## #####    #  #  ##  ##   #######    ## ### ### #    ## ##   # ##  ### # #  # #####  ## #
##   ## #    #   #### ##   ##  ### # #   #   ####  # # #   # ####  #### ###  ## #   ## ###   ##### #
#  #  # ########   ## #  ###  ## # #   # # ###  # ##   # #####    ##  #  #  ### ######     #   ##  #
## ##     #      #    ####   ##    ## #### #   ## ### ##       # #### ##   ###  #    #########    ##
#  ##### ## ### ##### ##   # #  #####        ###  #    ###########     #####   ## ##     #   ####  #
# ##   #    # # ##     # ##### ###  ##########   ## ##### #     #  # #   #   ###  #### ### #   ### #
# #### ###### #  ##### # ## #    # ##      ##  ####       ## ##   ## ###   ###   ##  #     ## ##   #
#    #    ##  ##  ##   #  # # ##      ## ###  ## #  # ###  #  # ###### # #  ## #### #########    ###
####   ##  # ####  ###### # #  ## #####  #   ##  # ##  ### #### ##   #   ####  #        #   ###### #
#  ####### #  ####     #  # ## ####   ## # ###  ## ###  ##   ## #  # #####    ### ##### ###        #
##    #  # ##  # #### ## ##      #  # #  # # # ##   ###  ### #  # ##     # #####    #     #### ## ##
#  ##   ##  ##      #    #  #### # ## #### #   #### # ## #   # ##  # # # # #   #### # ###    ###   #
## ####  ## ### ## ##########    # #    #  # #  #   #  # ###   ### ##### #   # #    ### ## # ##  # #
#     ##  #  ## #   #     ##  ####A####   ## ## # #### #   #####   #     #####   #####   ### #  ## #
# ## ##  ###    ### # #####  ###   #  ###### ## #    # ###  #    ### ###### #######    #  #  # ##  #
######  ## #######  #  ##   ###  ####  #   # #  #### #   ## # #### #    # # #    #  ## # ## ##  ## #
##     ##     ##   ###    ### # ## ###   #   # ##  # # #### # #    #### #     ##   ##  ###  ### #  #
#  # #  # ### #  ###   #####  #  # #   ####### #  ## #    #   # ##    #   ####### ######   ##   # ##
# ## ##   ##  # ##   # #     ### # # ###     #   ##  ## # #######  # ###### #   # #    # ###  ###  #
# ##### ###  ##  #####   #####   #   ##  # # ## ##  ##  #  ## ##  ##   ##     # #   ## #  ### # ## #
#   ##   #######    #  ###   ### ## ##  ## # ##  # ##  ###  #  # ##  #  ### #########  ## #   #  # #
# #  ###  ##   #### # ##   #  #   #  ## ## ###  ## #  ##### ##    ##### ##  #       # ### # ### ## #
#### # ## #  #      # #  # ## ### # ##   #   # ##  ##  ## #  ####   #    # ## # #####   #   #   #  #
#    # ## # ########### ####   #  #  # #### ## #  #### #  ##    # # #### #  # # #     # #######   ##
# ## #    #   ## #   ##  ##  #   ### # ## #  #   ##    # #### # # #   #  ##   # # ### #     ##  ####
# ##### #####      #  ##  ## ####### #  # ## ######## ##   #### # ### # ####### #   # #####  ## #  #
#     ###   #########  ##  ###    #  ##   ##       ## #  #  ##  # #   # ##   ## ### ###   ####  # ##
### #  ## #    ##   ##  ##     ## ##  ###  # #####  # # ### #  ## # ### #  #  #   #     #   #  ##  #
##  ##  # ####  ### ###  #######   ##   ## # ##  ##   #  #  # ##### # #   ### # ########## ## #### #
#  #### # # ###     # ##       ### #### ####  ##  ###### # ## ## #  # ##### # #  #     # #    #  # #
#####   #   # ## ## # ########  ##  # #    ## ### ##   # # ##  #   ## #   # # ##   ###   #######   #
#     # ###    #  # # # #    ##  ## # ### ##  #      #   #  ##   # #    #   # ### ## ### #    ### ##
## ####   ## #### # #   ### #### ## #  ## #  ## ###########  ####### #### ###     #    #   ####   ##
#  #  ###  #  ##  #   #  ##    #    # ##  # ###  ##     ##  ##  # #  #  #   ####### ######  ##  #  #
## ## ##  ### #  #### ##  ### #######  # ##   ####  ### #  ####   # ## ####    #    #   ###  # ### #
#  #  #  ##   # ##     ##  #  #       ## #  #    # ##     ### ## ##    # #####   ## # #  ### #  ####
# ###   ##  ###  #########   ## #####    # ##### # ###### ##      # ## #   # ######   ##     ##    #
#   #####  ## # ###   ##   # #     #######   #   #     ##    # ######  ###    #   ############## # #
# # ##    ##  # #   #  ## #### #####    ## ### #### ##  ########   #  ###  # ## #  # #         ### #
# #  # ####  ##   ####  # # #  # ##  # ##   #  # #   ## #   ##   # # ##   ## #  ##     #######  #  #
B ##   #    ####### ### #   # ##    ##  # # # ## # ###    #  ## ##   #  # ##   #### ## #     ## ## #
#  ##### ## #   ##    # ### #  ####  ##   ### #     ##### ##  # ###### ##  # ###  #  ###### ##   # #
## #   # ##   #    ## #  #####    ##  #####   # #####   #  ## #   # ######## # ## ##  #      ### # #
#  # #    ##### ##### ##   # ####  ##  ## ## ## #  ## # ####  ### #        # #    ### ### # ## # # #
## #### ###   ###     ####   ## ## ###    #  #    ##  #   #  ###  # ### ## # ## ### # ##  #    # # #
#     # #   #   ## ## #  ### #   #   ### ## #####  # ####   ## # ## ##  #  #    ##  #  # ### ###   #
##### # # #####    #  ## # #   #####   ###  # # ## #    ## ##  #  ###  ## ### #    ### # # #  #### #
# #   ### # # #######  #   ## ##   ### ##  ##   #  #### ##  ##   ##   ##  #   ######   # # ##   #  #
#   ###   #         ##   # ## #  #   #    #### ## ##  #  ####  # #  ###  ## ####     ### # ## ### ##
### # # ### ## ###########  # # ## #########   #  ### ##  ##  ##   ## # ######   ##### # #    #    #
##    # ##   #   ##      ## #    # #   #   # #   ## #  ##    ########   #   #  ###   #   ###### ####
#  ##   #  # # #    # ##    # ## #   #   #   # #      ##  # ##        #   #   ##   #   #           #
####################################################################################################
