############################A#
#              #     #       #
#  #     #     #     #       #
#  #           #     #       #
#  #                 #       #
#  #                 #       #
#  #                 #       #
#                            #
#                    #       #
#                 #     #    #
#     #           #     #    #
#     #     #     #     #    #
#     #           #     #    #
#     #     #     #     #    #
#     #     #     #     #    #
#     #     #     #     #    #
#     #     #     #     #    #
#     #     #     #     #    #
#           #     #     #    #
#     #     #           #    #
#     #     #     #     #    B
#     #     #     #     #    #
#     #     #     #     #    #
#     #     #     #     #    #
#     #     #     #     #    #
#           #     #     #    #
#     #     #           #    #
#     #     #     #     #    #
#     #     #     #     #    #
##############################
